11111111111111111111111
10222200022220000222201
10101010101010101010101
10020000000222220000001
10101210101010101010101
12002220000002222220201
10121012101010101010101
12002200222200220022001
10101010101010101010101
12202220000220002200021
10101010121010101010121
10020222200220022000221
10121010101010101010101
12022220022002200000201
10101010101010101012101
12202222000000220022001
11111111111111111111111